############################
#            ##            #
# #### ##### ## ##### #### #
# #  # #   # ## #   # #  # #
# #### ##### ## ##### #### #
#                          #
# #### ## ######## ## #### #
# #### ## ######## ## #### #
#      ##    ##    ##      #
###### ##### ## ##### ######
#    # ##### ## ##### #    #
#    # ##          ## #    #
#    # ## ###  ### ## #    #
###### ## #      # ## ######
          #      #          
###### ## #      # ## ######
#    # ## ######## ## #    #
#    # ##          ## #    #
#    # ## ######## ## #    #
###### ## ######## ## ######
#            ##            #
# #### ##### ## ##### #### #
# #### ##### ## ##### #### #
#   ##                ##   #
### ## ## ######## ## ## ###
### ## ## ######## ## ## ###
#      ##    ##    ##      #
# ########## ## ########## #
# ########## ## ########## #
#                          #
############################